0 0 0 0 0 0 0 0 0 0 0 0 0 0 0 0
0 0 T 0 0 # # 0 0 0 0 # 0 0 # 0
0 # 0 0 # # # # # 0 0 # # # # 0
0 # 0 0 # 0 0 0 0 0 0 # 0 T # 0
0 # # 0 0 0 0 0 0 0 # # 0 0 0 0
0 0 0 0 0 0 # 0 J 0 # 0 0 0 0 0
0 0 # 0 0 0 # # # 0 # 0 0 0 # 0
0 0 # 0 0 0 0 0 # # # 0 # 0 # 0
0 # # 0 0 # # 0 0 0 0 0 # # # 0
0 # C 0 0 # 0 0 # 0 0 0 0 C 0 0
0 # # # 0 0 0 0 # # # # # 0 0 0
0 0 0 0 0 0 0 0 0 0 0 0 0 0 0 0